type octile
height 37
width 37
map
@@@@@@S@@@@@S@@@@@S@@@@@S@@@@@S@@@@@@
@@@@@@.@@@@@.@@@@@.@@@@@.@@@@@.@@@@@@
@@@@@@.@@@@@.@@@@@.@@@@@.@@@@@.@@@@@@
@@@@@@.@@@@@.@@@@@.@@@@@.@@@@@.@@@@@@
@@@@@@.@@@@@.@@@@@.@@@@@.@@@@@.@@@@@@
@@@@@@.@@@@@.@@@@@.@@@@@.@@@@@.@@@@@@
S...................................S
@@@@@@.@@@@@.@@@@@.@@@@@.@@@@@.@@@@@@
@@@@@@.@@@@@.@@@@@.@@@@@.@@@@@.@@@@@@
@@@@@@.@@@@@.@@@@@.@@@@@.@@@@@.@@@@@@
@@@@@@.@@@@@.@@@@@.@@@@@.@@@@@.@@@@@@
@@@@@@.@@@@@.@@@@@.@@@@@.@@@@@.@@@@@@
S...................................S
@@@@@@.@@@@@.@@@@@.@@@@@.@@@@@.@@@@@@
@@@@@@.@@@@@.@@@@@.@@@@@.@@@@@.@@@@@@
@@@@@@.@@@@@.@@@@@.@@@@@.@@@@@.@@@@@@
@@@@@@.@@@@@.@@@@@.@@@@@.@@@@@.@@@@@@
@@@@@@.@@@@@.@@@@@.@@@@@.@@@@@.@@@@@@
S...................................S
@@@@@@.@@@@@.@@@@@.@@@@@.@@@@@.@@@@@@
@@@@@@.@@@@@.@@@@@.@@@@@.@@@@@.@@@@@@
@@@@@@.@@@@@.@@@@@.@@@@@.@@@@@.@@@@@@
@@@@@@.@@@@@.@@@@@.@@@@@.@@@@@.@@@@@@
@@@@@@.@@@@@.@@@@@.@@@@@.@@@@@.@@@@@@
S...................................S
@@@@@@.@@@@@.@@@@@.@@@@@.@@@@@.@@@@@@
@@@@@@.@@@@@.@@@@@.@@@@@.@@@@@.@@@@@@
@@@@@@.@@@@@.@@@@@.@@@@@.@@@@@.@@@@@@
@@@@@@.@@@@@.@@@@@.@@@@@.@@@@@.@@@@@@
@@@@@@.@@@@@.@@@@@.@@@@@.@@@@@.@@@@@@
S...................................S
@@@@@@.@@@@@.@@@@@.@@@@@.@@@@@.@@@@@@
@@@@@@.@@@@@.@@@@@.@@@@@.@@@@@.@@@@@@
@@@@@@.@@@@@.@@@@@.@@@@@.@@@@@.@@@@@@
@@@@@@.@@@@@.@@@@@.@@@@@.@@@@@.@@@@@@
@@@@@@.@@@@@.@@@@@.@@@@@.@@@@@.@@@@@@
@@@@@@S@@@@@S@@@@@S@@@@@S@@@@@S@@@@@@