type octile
height 13
width 18
map
@@@@@@S@@@@@S@@@@@@
@@@@@@.@@@@@.@@@@@@
@@@@@@.@@@@@.@@@@@@
@@@@@@.@@@@@.@@@@@@
@@@@@@.@@@@@.@@@@@@
@@@@@@.@@@@@.@@@@@@
S.................S
@@@@@@.@@@@@.@@@@@@
@@@@@@.@@@@@.@@@@@@
@@@@@@.@@@@@.@@@@@@
@@@@@@.@@@@@.@@@@@@
@@@@@@.@@@@@.@@@@@@
@@@@@@S@@@@@S@@@@@@