type octile
height 13
width 13
map
@@@@@@S@@@@@@
@@@@@@.@@@@@@
@@@@@@.@@@@@@
@@@@@@.@@@@@@
@@@@@@.@@@@@@
@@@@@@.@@@@@@
S...........S
@@@@@@.@@@@@@
@@@@@@.@@@@@@
@@@@@@.@@@@@@
@@@@@@.@@@@@@
@@@@@@.@@@@@@
@@@@@@S@@@@@@