type octile
height 7
width 23
map
TTTTTTTTTTTTTTTTTTTTTTT
S.....................S
TTTTTTTTTTT.TTTTTTTTTTT
TTTTTTTTTTT.TTTTTTTTTTT
TTTTTTTTTTTSTTTTTTTTTTT

