type octile
height 7
width 23
map
TTTTTTTTTTTSTTTTTTTTTTT
TTTTTTTTTTT.TTTTTTTTTTT
TTTTTTTTTTT.TTTTTTTTTTT
S.....................S
TTTTTTTTTTT.TTTTTTTTTTT
TTTTTTTTTTT.TTTTTTTTTTT
TTTTTTTTTTTSTTTTTTTTTTT

